###################
#........#........#
#.###.##.#.##.###.#
#o###.##.#.##.###o#
#.................#
#.##.#.#####.#.##.#
#....#.......#....#
#####.### ###.#####
    #.#     #.#    
#####.# ### #.#####
     .  #G#  .     
#####.# ### #.#####
    #.#     #.#    
#####.# #####.#####
#........#........#
#.##.###.#.###.##.#
#P..#...........#o#
###.#.#.#####.#.###
#.....#...#.....#.#
#.###.###.###.###.#
#.................#
###################